21 19
1 1 1 1 1 1 1 1 1 1 1 1 1 1 1 1 1 1 1
1 0 0 0 0 0 0 0 0 1 0 0 0 0 0 0 0 0 1
1 0 1 1 0 1 1 1 0 1 0 1 1 1 0 1 1 0 1
1 0 0 0 0 0 0 0 0 0 0 0 0 0 0 0 0 0 1
1 0 1 1 0 1 0 1 1 1 1 1 0 1 0 1 1 0 1
1 0 0 0 0 1 0 0 0 1 0 0 0 1 0 0 0 0 1
1 1 1 1 0 1 1 1 0 1 0 1 1 1 0 1 1 1 1
0 0 0 1 0 1 0 0 2 3 0 0 0 1 0 1 0 0 0
1 1 1 1 0 1 0 1 1 5 1 1 0 1 0 1 1 1 1
0 0 0 0 0 0 0 1 6 7 8 1 0 0 0 0 0 0 0
1 1 1 1 0 1 0 1 1 1 1 1 0 1 0 1 1 1 1
0 0 0 1 0 1 0 0 0 0 0 0 0 1 0 1 0 0 0
1 1 1 1 0 1 0 1 1 1 1 1 0 1 0 1 1 1 1
1 0 0 0 0 0 0 0 0 1 0 0 0 0 0 0 0 0 1
1 0 1 1 0 1 1 1 0 1 0 1 1 1 0 1 1 0 1
1 0 0 1 0 0 0 0 0 9 0 0 0 0 0 1 0 0 1
1 1 0 1 0 1 0 1 1 1 1 1 0 1 0 1 0 1 1
1 0 0 0 0 1 0 0 0 1 0 0 0 1 0 0 0 0 1
1 0 1 1 1 1 1 1 0 1 0 1 1 1 1 1 1 0 1
1 0 0 0 0 0 0 0 0 0 0 0 0 0 0 0 0 0 1
1 1 1 1 1 1 1 1 1 1 1 1 1 1 1 1 1 1 1